1111111111111111111111111111111111
1001C0000100010000C100001000000001
1001010001000100000100001000C00001
1001010001000100000100001000001001
1001010001000100000000001000001001
1000010000000C00000000000C00001001
1000000001000100E00100001000001001
1001C00001000100P00100001000000001
1001010001000100000100001000001001
1001010001000100000000001000001001
1001010000000100000100000000001001
10000100000C00000C0100001000001001
1111111111111111111111111111111111
